me=wo
he=ta
she=ta
it=ta
we=women
you=ni
they=tamen
not=bu
american=meiguo ren
chinese=zhongguo ren
chinese=zhongwen
japanese=riben ren
japanese=ri yu
korean=hanguo ren, hanyu
indian=yindu ren, yindu yu
english=yin yu
yes=shi
no=fou
thank you=xie xie
please=qing
excuse me=dui bu qi
hello=ni hao
goodbye=zai jian
goodmorning=zao an
goodafternoon=wu an
goodevening=wang an
goodnight=wang an
goodluck=haoyun
congratulations=he li
happy=bu kuai le
sad=bei shang
angry=fen nu
afraid=kong ju
surprised=jing ya
proud=jiao ao
sorry=dui bu qi
love=ai
like=xihuan
hate=hen
want=yao
need=xuyao
have=you
buy=mai
sell=mai
sell=shou
price=jia ge
cheap=pian yi
expensive=gui
good=hao
bad=huai
new=xin
old=jiu
big=da
small=xiao
long=chang
short=duan
high=gao
low=di
light=qing
dark=an
bright=ming
heavy=zhong
light=qing
hot=re
cold=leng
warm=wenn
cool=liang
fast=kuai
slow=man
easy=jian dan
difficult=nan
strong=qiang
weak=rhuo
beautiful=mei
ugly=chou
rich=fu
poor=qiong
happy=gao xing
tired=lei
thirsty=ke
hungry=e
full=ba
clean=gan jing
dirty=zang
open=kai
close=bi
early=zao
late=wan
right=zheng
wrong=cuo
true=shi
false=huang
big=dà
small=xiǎo
best=zui hao
worst=zui huai
normal=putong
strange=qiguai
unique=duyi
common=pinyin
rare=qidian
previous=qian
next=xiayi
first=di yi
last=zui hou
empty=kong
full=man
empty=kong
full=man
day=ri
night=ye
morning=zaoshang
afternoon=xia wu
evening=wanshang
today=jin tian
tomorrow=ming tian
yesterday=zuo tian
time=shi jian
hour=xiao shi
minute=fen zhong
second=miao
year=nian
month=yue
week=xing qi
day=tian
sun=tai yang
moon=yue liang
star=xing xing
sky=tian kong
earth=di qiu
land=lu di
water=shui
fire=huo
air=kong qi
wind=feng
rain=yu
snow=xue
cloud=yun
mountain=shan
river=he
lake=hu
sea=hai
ocean=yang
forest=sen lin
flower=hua
tree=shu
grass=cao
